{
  "map_tile_set": "/Level1_Map_Tileset.png",
  "mapTileIds": [[1, 2, 3, 3, 3, 3, 3, 3, 3, 3, 3, 3, 3, 3, 3, 5, 6],
    [7, 8, 16, 16, 16, 16, 16, 16, 16, 16, 16, 16, 9, 16, 16, 11, 12],
    [7, 8, 16, 9, 16, 9, 16, 9, 16, 9, 16, 9, 10, 9, 16, 11, 12],
    [7, 8, 16, 10, 16, 10, 16, 10, 16, 10, 16, 10, 16, 10, 16, 11, 12],
    [7, 8, 16, 9, 16, 9, 16, 9, 16, 9, 9, 9, 16, 9, 16, 11, 12],
    [7, 8, 16, 10, 16, 10, 16, 10, 16, 10, 10, 10, 16, 10, 16, 11, 12],
    [7, 8, 9, 9, 16, 9, 16, 9, 16, 9, 16, 9, 16, 9, 16, 11, 12],
    [7, 8, 10, 10, 16, 10, 16, 10, 16, 10, 16, 9, 16, 10, 16, 11, 12],
    [7, 8, 9, 9, 16, 9, 16, 9, 16, 9, 16, 9, 9, 9, 16, 11, 12],
    [7, 8, 10, 10, 16, 10, 16, 10, 16, 10, 16, 10, 10, 9, 16, 11, 12],
    [7, 8, 16, 9, 16, 9, 16, 9, 16, 9, 16, 9, 16, 9, 16, 11, 12],
    [7, 8, 16, 10, 9, 10, 16, 10, 16, 10, 16, 10, 16, 10, 16, 11, 12],
    [13, 14, 15, 15, 15, 15, 15, 15, 15, 15, 15, 15, 15, 15, 15, 17, 18]]

}
