{
  "columns": 17,
  "rows": 13,
  "mapTileIds": [[4, 5, 5, 5, 5, 5, 5, 5, 5, 5, 5, 5, 5, 5, 5, 5, 6],
                [4, 4, 2, 2, 2, 2, 2, 9, 9, 2, 9, 9, 1, 2, 2, 6, 6],
                [4, 4, 2, 1, 2, 1, 2, 1, 2, 1, 9, 1, 9, 1, 2, 6, 6],
                [4, 4, 9, 2, 2, 2, 2, 2, 2, 9, 2, 2, 2, 9, 9, 6, 6],
                [4, 4, 9, 1, 9, 1, 2, 1, 2, 1, 1, 1, 2, 1, 9, 6, 6],
                [4, 4, 9, 2, 2, 9, 2, 9, 9, 9, 2, 2, 2, 2, 2, 6, 6],
                [4, 4, 1, 1, 2, 1, 2, 1, 2, 1, 2, 1, 2, 1, 2, 6, 6],
                [4, 4, 2, 2, 9, 2, 9, 2, 2, 2, 2, 1, 9, 2, 9, 6, 6],
                [4, 4, 1, 1, 2, 1, 2, 1, 2, 1, 9, 1, 1, 1, 2, 6, 6],
                [4, 4, 9, 2, 2, 2, 2, 2, 2, 2, 9, 9, 9, 1, 9, 6, 6],
                [4, 4, 2, 1, 9, 1, 2, 1, 2, 1, 9, 1, 2, 1, 2, 6, 6],
                [4, 4, 2, 2, 1, 9, 2, 9, 2, 2, 2, 9, 2, 2, 2, 6, 6],
                [4, 7, 5, 5, 5, 5, 5, 5, 5, 5, 5, 5, 5, 5, 5, 8, 6]],
  "tiles": [
    {
      "id": 4,
      "type": "wall",
      "walkable": false,
      "destroyable": false,
      "imgPath": "src/main/resources/Level1Tiles/wall_1.png"
    }
  ]

}
