{
  "mapImg": "/Map_Level2.png",
  "map_data": [[1, 1, 1, 1, 1, 1, 1, 1, 1, 1, 1, 1, 1, 1, 1, 1, 1],
              [1, 1, 0, 0, 0, 0, 0, 0, 1, 0, 0, 0, 0, 0, 0, 1, 1],
              [1, 1, 0, 1, 0, 1, 0, 1, 0, 1, 0, 1, 0, 1, 0, 1, 1],
              [1, 1, 0, 0, 0, 0, 0, 0, 0, 0, 0, 0, 0, 0, 0, 1, 1],
              [1, 1, 0, 1, 0, 1, 0, 1, 0, 1, 0, 1, 0, 1, 0, 1, 1],
              [1, 1, 0, 0, 0, 0, 0, 0, 0, 0, 0, 0, 0, 0, 0, 1, 1],
              [1, 1, 0, 1, 0, 1, 0, 1, 0, 1, 0, 1, 0, 1, 0, 1, 1],
              [1, 1, 0, 0, 0, 0, 0, 1, 0, 0, 0, 0, 0, 0, 0, 1, 1],
              [1, 1, 0, 1, 0, 1, 0, 1, 0, 1, 0, 1, 0, 1, 0, 1, 1],
              [1, 1, 0, 1, 0, 0, 0, 0, 1, 0, 0, 0, 0, 0, 0, 1, 1],
              [1, 1, 0, 1, 0, 1, 0, 1, 0, 1, 0, 1, 1, 1, 0, 1, 1],
              [1, 1, 0, 1, 0, 0, 0, 0, 0, 0, 0, 0, 0, 0, 0, 1, 1],
              [1, 1, 1, 1, 1, 1, 1, 1, 1, 1, 1, 1, 1, 1, 1, 1, 1]],

  "player_spawn": {
    "x": 2,
    "y": 1
  },
  "enemies_spawn":
    [

    ],
  "sprite_sheets_path":
    {
      "bomb":"/Bomb_SpriteSheet_Level2.png",
      "soft_blocks": "/SoftBlocks_SpriteSheet_Level2.png",
      "explosion": "/Explosion_SpriteSheet_Level2.png"
    },
  "power_ups_spawn": [
    {
      "x": 2,
      "y": 3,
      "type": "BOMB"
    },
    {
      "x": 2,
      "y": 4,
      "type": "HEART"
    },
    {
      "x": 2,
      "y": 2,
      "type": "PORTAL"
    }
  ]
}
