{
  "map_tile_set": "/Stage1_Map_Tileset.png",
  "map_ids": [[1, 2, 3, 3, 3, 3, 3, 3, 3, 3, 3, 3, 3, 3, 3, 5, 6],
    [7, 8, 16, 16, 16, 16, 16, 16, 16, 16, 16, 16, 9, 16, 16, 11, 12],
    [7, 8, 16, 9, 16, 9, 16, 9, 16, 9, 16, 9, 10, 9, 16, 11, 12],
    [7, 8, 16, 10, 16, 10, 16, 10, 16, 10, 16, 10, 16, 10, 16, 11, 12],
    [7, 8, 16, 9, 16, 9, 16, 9, 16, 9, 9, 9, 16, 9, 16, 11, 12],
    [7, 8, 16, 10, 16, 10, 16, 10, 16, 10, 10, 10, 16, 10, 16, 11, 12],
    [7, 8, 9, 9, 16, 9, 16, 9, 16, 9, 16, 9, 16, 9, 16, 11, 12],
    [7, 8, 10, 10, 16, 10, 16, 10, 16, 10, 16, 9, 16, 10, 16, 11, 12],
    [7, 8, 9, 9, 16, 9, 16, 9, 16, 9, 16, 9, 9, 9, 16, 11, 12],
    [7, 8, 10, 10, 16, 10, 16, 10, 16, 10, 16, 10, 10, 9, 16, 11, 12],
    [7, 8, 16, 9, 16, 9, 16, 9, 16, 9, 16, 9, 16, 9, 16, 11, 12],
    [7, 8, 16, 10, 9, 10, 16, 10, 16, 10, 16, 10, 16, 10, 16, 11, 12],
    [13, 14, 15, 15, 15, 15, 15, 15, 15, 15, 15, 15, 15, 15, 15, 17, 18]],
  "player_spawn": {
    "x": 4,
    "y": 1
  },
  "enemies_spawn":
    [

    ],
  "sprite_sheets_path":
    {
      "bomb":"/Bomb_SpriteSheet_Level1.png",
      "soft_blocks": "/SoftBlocks_SpriteSheet_Level1.png",
      "explosion": "/Explosion_SpriteSheet_Level1.png"
    },
  "power_ups_spawn": [

  ],
  "soft_blocks_spawn": [

  ]
}
