11111111111111111
11000000000000011
11000000000000011
11001000000000011
11000010000000011
11000000000000011
11000000100000011
11000000000000011
11000000000010011
11000000000000011
11000001000000011
11000000000000011
11111111111111111
